#####################################################################################################################
#                                                                                                                   #
#                                                                                                                   #
#                                                                                                                   #
#                                                                                                                   #
#                                                                                                                   #
#                                                                                                                   #
#                                                                                                                   #
#                                                                                                                   #
#                                                                                                                   #
#                                                                                                                   #
#                                                                                                                   #
#                                                                                                                   #
#                                                                                                                   #
#                                                                                                                   #
#                                                                                                                   #
#                                                                                                                   #
#                                                                                                                   #
#                                                                                                                   #
#                                                                                                                   #
#                                                                                                                   #
#                                                                                                                   #
#                                                                                                                   #
#                                                                                                                   #
#                                                                                                                   #
#                                                                                                                   #
#                                                                                                                   #
#                                                                                                                   #
#                                                                                                                   #
#                                                                                                                   #
#                                                                                                                   #
#                                                     O                                                             #
#                                                                                                                   #
#                                                                                                                   #
#                                                                                                                   #
#                                                                                                                   #
#                                                                                                                   #
#                                                                                                                   #
#                                                                                                                   #
#                                                                                                                   #
#                                                                                                                   #
#                                                                                                                   #
#                                                                                                                   #
#                                                                                                                   #
#                                                                                                                   #
#                                                                                                                   #
#                                                                                                                   #
#                                                                                                                   #
#                                                                                                                   #
#                                                                                                                   #
#                                                                                                                   #
#                                                                                                                   #
#####################################################################################################################
