#############################################################################################################################
#                                                                                                                           #
#                                                                                                                           #
#                                                                                                                           #
#                                                                                                                           #
#                                                                                                                           #
#                                                                                                                           #
#                                                                                                                           #
#                                                                                                                           #
#                                                                                                                           #
#                                                                                                                           #
#                                                                                                                           #
#                                                                                                                           #
#                                                                                                                           #
#                                                                                                                           #
#                                                                                                                           #
#                                                                                                                           #
#                                                                                                                           #
#                                                                                                                           #
#                                                                                                                           #
#                      #   #   ###   ####      #####   ###   #   #  #   #   ###  #####    ####   #####                      #
#                      ## ##  #   #  #   #     #      #   #  ##  #  ##  #  #   #   #      #   #  #                          #
#                      # # #  #####  ####      #      #####  # # #  # # #  #   #   #      ####   ####                       #
#                      #   #  #   #  #         #      #   #  #  ##  #  ##  #   #   #      #   #  #                          #
#                      #   #  #   #  #         #####  #   #  #   #  #   #   ###    #      ####   #####                      #
#                                                                                                                           #
#                                                                                                                           #
#                                         #       ###   #####  ####   #####  ####                                           #
#                                         #      #   #  #   #  #   #  #      #   #                                          #
#                                         #      #   #  #####  #   #  ####   #   #                                          #
#                                         #      #   #  #   #  #   #  #      #   #                                          #
#                                         #####   ###   #   #  ####   #####  ####                                           #
#                                                                                                                           #
#                                                                                                                           #
#                                                                                                                           #
#                                                                                                                           #
#                                                                                                                           #
#                                                                                                                           #
#                                                                                                                           #
#                                                                                                                           #
#                                                                                                                           #
#                                                            o                                                              #
#                                                                                                                           #
#                                                                                                                           #
#                                                                                                                           #
#                                                                                                                           #
#                                                                                                                           #
#                                                                                                                           #
#                                                                                                                           #
#                                                                                                                           #
#                                                                                                                           #
#                                                                                                                           #
#                                                                                                                           #
#                                                                                                                           #
#                                                                                                                           #
#                                                                                                                           #
#                                                                                                                           #
#############################################################################################################################
