#############################################################################################################################
#                                                                                                                           #
#                                                                                                                           #
#                                                                                                                           #
#                                                                                                                           #
#                                                                                                                           #
#                                                                                                                           #
#                                                                                                                           #
#                                                                                                                           #
#                                                                                                                           #
#                                                                                                                           #
#                                                                                                                           #
#                                                                                                                           #
#                                                                                                                           #
#                         RRRRRRRRRRRRRRRRRRRRRRRRRRRRRRRRRRRRRRRRRRRRRRRRRRRRRRRRRRRR                                      #
#                         R##########################################################R                                      #
#                         R#                                                        #R                                      #
#                         R#                                                        #R                                      #
#                         R#                                                        #R                                      #
#                         R#                         O                              #R                                      #
#                         R#                                                        #R                                      #
#                         R#                                                        #R                                      #
#                         R#                                                        #R                                      #
#                         R#                                                        #R                                      #
#                         R#                                                        #R                                      #
#                         R##########################################################R                                      #
#                         RRRRRRRRRRRRRRRRRRRRRRRRRRRRRRRRRRRRRRRRRRRRRRRRRRRRRRRRRRRR                                      #
#					                                                                                    #
#						                                                                            #
#						                                                                            #
#						                                                                            #
#						                                                                            #
#						                                                                            #
#						                                                                            #
#						                                                                            #
#						                                                                            #
#						                                                                            #
#						                                                                            #
#############################################################################################################################		 